XXXXXXXXXXXXXXXXXXXXXXXXXXXXXXXXXXXXXXXXXXXXX
X111111111111111232112X12c21X333111231312311X
X1223XXXX22212X1231231XX131XX332221123X33212X
X1223d11111112X312111231XXXX1332221123X33212X
X1223XXXX22212X11111111111111111111122X33212X
X1223333333333X11111111111111111111122X33212X
X1223333333333X11112211111XXXXXXXXXXXXX33212X
X1223333333333X1222223333333333X31a231X33212X
X1231XXXXXXXXXX12111X3333333333X122321X33212X
X1111111111111111111X3333333333X112113X33212X
X1112222222123122XXXXXXXXX11111X113123111333X
X3332222222123123313X1231231231XXXXX11112XXXX
X2211111111232323211X3213123123X111X21113111X
XXXXXXXXXXXX32111132131113111312311XXXXXX111X
X1111122222232331231XXXXXXXX1231312333112322X
X333XXXXXXX312333312XX1232232212123111112211X
X33333b1X21212121212121212121212121212121212X
X12121212121212121212121212121XXXXXX11113111X
XXXXXXXXXXXXXXXXXXXXXXXXXXXXXXXXXXXXXXXXXXXXX
